*******@3*****4
*******@@@@@@@@
*******@******5
2*****3@4***@@@
@@@@@@@@@@@@@@@
*******@*******
*******1***2**@
*******@******@
*******@@@@@@@@
*******@5@***1@
*******@X@****@